{
    "levels": {
        "map1": {
            "map": [
                [2, 2, 2, 2, 2, 2, 2, 2, 2, 2, 2, 2, 2, 2],
                [2, 2, 2, 2, 2, 2, 2, 2, 2, 2, 2, 2, 2, 2],
                [1, 1, 1, 1, 1, 1, 0, 1, 1, 1, 1, 1, 1, 1],
                [1, 1, 1, 3, 1, 1, 0, 1, 1, 1, 1, 1, 1, 1],
                [1, 0, 1, 1, 1, 1, 0, 1, 0, 0, 0, 0, 0, 1],
                [1, 0, 1, 1, 1, 1, 0, 1, 1, 1, 1, 1, 1, 1],
                [1, 0, 1, 1, 1, 1, 0, 1, 1, 1, 3, 1, 1, 1],
                [1, 0, 1, 1, 1, 1, 0, 1, 1, 1, 1, 1, 1, 1],
                [1, 0, 1, 1, 1, 1, 0, 1, 1, 1, 1, 1, 1, 1],
                [1, 1, 1, 1, 1, 0, 0, 0, 1, 1, 1, 1, 1, 1],
                [1, 1, 1, 3, 1, 1, 1, 1, 1, 1, 1, 1, 1, 1],
                [1, 1, 1, 1, 1, 1, 1, 1, 1, 0, 1, 3, 1, 1],
                [1, 1, 0, 0, 0, 0, 1, 1, 1, 0, 1, 1, 1, 1],
                [1, 1, 1, 1, 1, 1, 1, 1, 1, 0, 1, 1, 1, 1],
                [1, 1, 1, 1, 1, 1, 1, 1, 1, 0, 1, 1, 1, 1],
                [1, 1, 1, 1, 1, 1, 1, 1, 1, 0, 1, 1, 1, 1],
                [1, 1, 1, 1, 1, 1, 1, 1, 1, 1, 1, 1, 1, 1]
            ],
            "source": "map1"
        },
        "map2": {
            "map":[
                [2, 2, 2, 2, 2, 2, 2, 2, 2, 2, 2, 2, 2, 2],
                [2, 2, 2, 2, 2, 2, 2, 2, 2, 2, 2, 2, 2, 2],
                [1, 1, 1, 1, 1, 1, 0, 1, 1, 1, 1, 1, 1, 1],
                [1, 1, 1, 3, 1, 1, 0, 1, 1, 1, 3, 1, 1, 1],
                [1, 1, 1, 1, 1, 1, 0, 1, 1, 1, 1, 1, 1, 1],
                [1, 1, 1, 0, 0, 0, 0, 1, 1, 1, 1, 1, 1, 1],
                [1, 1, 1, 1, 1, 1, 0, 1, 1, 1, 1, 1, 1, 1],
                [1, 1, 0, 1, 1, 1, 0, 1, 1, 1, 1, 1, 1, 1],
                [1, 1, 0, 1, 1, 1, 0, 1, 1, 3, 1, 1, 1, 1],
                [1, 1, 0, 1, 1, 0, 0, 0, 1, 1, 1, 1, 1, 1],
                [1, 1, 1, 1, 1, 1, 1, 1, 1, 0, 0, 0, 1, 1],
                [1, 0, 0, 0, 1, 1, 1, 1, 1, 1, 1, 1, 1, 1],
                [1, 1, 1, 1, 1, 1, 1, 1, 1, 1, 3, 1, 1, 1],
                [1, 1, 1, 1, 1, 0, 0, 0, 1, 1, 1, 1, 1, 1],
                [1, 1, 1, 1, 1, 1, 1, 1, 1, 1, 1, 1, 1, 1],
                [1, 1, 1, 1, 1, 1, 1, 1, 1, 1, 1, 1, 1, 1],
                [1, 1, 1, 1, 1, 1, 1, 1, 1, 1, 1, 1, 1, 1]
            ],
            "source":"map2"
        }
    }
}
